wwwwwwwwwwwwwwwwwww
wi.............k..w
wwwsw.......wswww.w
w..s.........s....w
w..s.........s..m.w
w..s........wswww.w
w..s.........s....w
w..s.........s....w
w..s.........s....w
w..s.........s....w
w..s.........s....w
w..s.........s....w
w..s.........s....w
w..s.........s....w
w..s.........s....w
w..s.m.......s....w
w..wwsw......s....w
w....s.......s....w
w....s.......s....w
w....s.......s....w
w....s.......s....w
w....s.......s....w
w....s.......s....w
w....s.......s....w
w....s.......s....w
w....s.......s....w
wo.w.smw....m.....w
wwwwwwwwwwwwwwwwwww