wwwwwwwwwwwwwwwwwwwwwwwwwwwwwwwwwwwwwwwwwwwwwwwwwwwwwwwwwwwwwwwwwwwwwwwwwwwww
w...........................................................................w
w...........................................................................w
wo....m..........wwwswww....................................................w
wwwwwwwsw...........s.......................................................w
w......s............s.......................................................w
w......s............s.......................................................w
w......s............s.......................................................w
w.....wwwwwwwwww....s.......................................................w
w...................s.......................................................w
w...................s.......................................................w
w...................s.......................................................w
w.................wswww.....................................................w
w..................s........................................................w
w..................s........................................................w
w..................s........................................................w
w..................s........................................................w
w..................s........................................................w
w..................s........................................................w
w..................s........................................................w
w..................s........................................................w
w..................s................................................k.......w
w..................s.............................................wwwwwsw....w
w..................s..................................................s.....w
w..................s...............................................s..s.....w
w..................s...............................................ss.s.....w
w..................s.............m.................................s.ss.....w
w..................s........wwswwwwwwwwwwwwwwwsww..................s..s.....w
w..................s..........s...............s....................s........w
w..................s..........s...............s....................s........w
w..................s..........s...............s....................s........w
w..................s..m.......s...............s....................s........w
w................wwwwwsw......s...............s....................s........w
w.....................s.......s...............s....................s........w
w.....................s...m...s...............s...m................s........w
w.....................wwwwwwwww......wwwwwwwwwwwwwwwwwwwwsww.......s........w
w........................................................s.........s........w
w........................................................s.........s........w
w........................................................s.........s........w
w........................................................s.........s........w
w........................................................s.........s........w
w........................................................s.........s........w
w........................................................s.........s........w
w........................................................s.........s........w
w........................................................s.........s........w
w........................................................s.........s........w
w........................................................s.........s........w
w........................................................s.........s........w
w........................................................s.........s........w
wi.w.............m..w..........m...w.............m.w.....s.....m...s........w
wwwwwwwwwwwwwwwwwwwwwwwwwwwwwwwwwwwwwwwwwwwwwwwwwwwwwwwwwwwwwwwwwwwwwwwwwwwww