wwwwwwwwwwwwwwwwwwwwwwwwwwwwwwwwwwwwwwwwwwwww
w..............k............................w
w...........wswww...........................w
w............s..............................w
w............s..............................w
w............s..m...........................w
w...........wswww...........................w
w............s..............................w
w............s..............................w
w............s..............................w
w............s..............................w
w............s..............................w
w............s..............................w
w............s..............................w
w............s..............................w
w............s..............................w
w............s..............................w
w............s..............................w
w............s..........wwwwws..............w
w............s...............s..............w
w............s...............s..............w
w............s...............s..............w
w............s...............s..............w
w............s...............s..............w
w............s...............s..............w
wo..m........s...............s.............iw
wwwwwwwwwwwwwwwwwwwwwwwwwwwwwwwwwwwwwwwwwwwww
