wwwwwwwwwwwwwwwwwww
w..............k..w
w...........wswww.w
w............s....w
w............s..m.w
w...........wswww.w
w............s....w
w............s....w
w............s....w
w............s....w
w............s....w
w............s....w
w............s....w
w............s....w
w............s....w
w............s....w
w............s....w
w............s....w
w............s....w
w............s....w
w............s....w
w............s....w
w............s....w
w............s....w
w............s....w
w............s....w
woi..l...g...s....w
wwwwwwwwwwwwwwwwwww