8
8
1  1  1  1  1  1  1  1
1  1  1  1  14 12 0  1
1  1  0  1  0  1  0  1
1  1  0  1  0  1  0  1
1  1  14 12 0  1  0  1
1  1  0  1  1  1  0  1
1  1  1  1  1  1  2  1
1  1  1  1  1  1  1  1
